12
12
111000000000
111000000000
111000011111
111110010111
001111010110
000000010110
011101001100
011100000000
011100000000
000111100110
000011100110
110011100000